 //////
//    //
/ # ## /
/OOOOOO/
/ ## # /
/// *///
  ////