 ####
##  #
#&* #
##* ##
## * #
#O*  #
#OO@O#
######