 #######
 #     ###
##*###   #
# & *  * #
# OO# * ##
##OO#   #
 ########