######
#    #
#    #
#& * #
# * ##
#    #
# O O#
######