11111111111111
11110400111111
11110300111111
11000000000011
11400020030411
11003000000011
11000003000011
11111100001111
11111104001111
11111111111111
