00001111000011110000
00011000111100011000
00110000000000001100
00011000020000011000
00001100300300110000
00000110000001100000
00000011044011000000
00000001111110000000

