8 8
1 1 1 1 1 1 1 1
1 1 1 2 1 1 1 1
1 1 1 0 1 1 1 1
1 1 1 3 0 3 2 1
1 2 0 3 6 1 1 1
1 1 1 1 3 1 1 1
1 1 1 1 2 1 1 1
1 1 1 1 1 1 1 1
