8 7
1 1 1 1 1 1 1 1
1 0 0 1 0 0 0 1
1 0 4 2 2 4 0 1
1 0 4 2 6 0 1 1
1 8 4 2 2 4 0 1
1 0 0 1 0 0 0 1
1 1 1 1 1 1 1 1