8 7
1 1 1 1 1 1 1 1
1 0 0 1 0 0 0 1
1 0 3 2 2 3 0 1
1 0 3 2 0 0 1 1
1 6 3 2 2 3 0 1
1 0 0 1 0 0 0 1
1 1 1 1 1 1 1 1