 #####
 #& ###
 # *  #
### # ##
#O# #  #
#O*  # #
#O   * #
########